本词表根据NorthEuraLex数据库概念框架构建
日语部分填写人：李霁霄 日本关西学院大学 社会学系本科生 留学经验4年
英语	汉语	日语
#身体语义场
eye	眼睛	目
ear	耳朵	耳
nose	鼻子	鼻
mouth	嘴	口
tooth	牙	歯
tongue	舌	舌
lip	唇	唇
cheek	颊	頬
face	脸	顔
forehead	额	額
hair	头发	髪
moustache	髭	口ひげ
beard	胡子	あごひげ
chin	下巴	顎
throat	喉	喉
neck	颈	首
nape	后颈	首筋
head	头	頭
back	背	背
spine	脊椎	脊椎
belly	肚子	おなか
navel	肚脐	へそ
bosom	乳房	乳房
chest	胸	胸
shoulder	肩	肩
arm	臂	臂
elbow	肘	肘
hand	手	手
palm	手心	手のひら
finger	手指	指
fingernail	指甲	爪
toe	趾	つま先
foot	脚	足
heel	脚跟	かかと
knee	膝	膝
thigh	大腿	もも
leg	腿	脚
body	身体	体
skin	皮肤	肌
blood	血	血
vein	血管	血管
bone	骨	骨
brain	脑	脳
heart	心	心臓
stomach	胃	胃
tear	眼泪	涙
health	健康	健康
illness	疾病	疾病
pain	疼痛	痛み
wound	伤口	傷
fever	发热	熱
medicine	药	薬
hungry	饥饿	ひもじい
sick	生病	病気
cough	咳嗽	咳
recover	痊愈	回復
die	死	死ぬ
get tired	疲劳	疲労
be alive	生存	生存
be born	出生	生まれる
breathe	呼吸	呼吸
liver	肝	肝臓
#自然世界语义场
sky	天空	天空
sun	太阳	太陽
moon	月亮	つき
star	星	星
air	空气	空気
wind	风	風
wave	浪	波
water	水	水
stone	石	石
soil	土	土
ground	地面	地面
earth	地球	地球
dust	尘	ちり
smoke	烟	煙
spark	火花	火花
fire	火	火
light	光	光
shadow	影	影
weather	天气	天気
fog	雾	霧
cloud	云	雲
rain	雨	雨
snow	雪	雪
ice	冰	氷
frost	霜	霜
chill	冷	冷気
rainbow	彩虹	虹
thunder	雷	雷
current	水流	流れ
drop	滴	滴
foam	泡沫	泡
dirt	泥土	泥
lake	湖	湖
swamp	沼泽	沼地
moor	荒原	原野
meadow	草地	草地
forest	森林	森
hill	丘	丘
elevation	海拔	海抜
mountain	山	山
summit	山顶	頂上
cave	山洞	洞穴
slope	坡	坂
source	源头	もと
brook	溪	小川
river	河	川
shore	岸	岸
coast	海岸	海岸
land	土地	陸地
sea	海	海
island	岛	島
iron	钢	鉄
gold	金	金
silver	银	銀
coal	煤	石炭
glass	玻璃	ガラス
clay	黏土	粘土
shine	发光	光らせる
thunder	雷电	雷鳴
blow	吹	吹く
flow	流	流れる
freeze	冰冻	冷凍
thaw	解冻	解凍
melt	融化	溶ける
sand	沙	砂
dry	干燥	乾燥
rot	腐烂	腐る
decay	腐朽	朽ちる
sound	声音	声
rock	岩石	岩
#农业与植物语义场
flower	花	花
grass	草	草
root	根	根
tree	树	木
trunk	树干	幹
bark	树皮	樹皮
branch	树枝	枝
leaf	叶	葉
birch	桦	樺の木
pine	松	松
willow	柳	柳
berry	浆果	ベリー
apple	苹果	りんご
mushroom	蘑菇	キノコ
onion	洋葱	タマネギ
seed	种子	種
grain	谷物	穀物
hay	干草	干し草
wheat	小麦	小麦
buckwheat	荞麦	そば
rose	玫瑰	ローズ
chrysanthemum	菊花	菊
#动物语义场
horn	角	角
feather	羽毛	羽
fur	毛皮	毛皮
wing	翅膀	翼
claw	爪子	鉤爪
tail	尾巴	しっぽ
egg	蛋	卵
nest	巢	巣
lair	巢穴	穴
animal	动物	動物
flock	群	群れ
cow	牛	牛
bull	公牛	種牛
horse	马	馬
sheep	羊	羊
pig	猪	豚
dog	狗	犬
cat	猫	猫
bear	熊	熊
squirrel	松鼠	リス
fox	狐	狐
hare	兔	うさぎ
mouse	鼠	鼠
wolf	狼	狼
bird	鸟	鳥
chicken	鸡	鶏
cock	公鸡	雄鶏
goose	鹅	ガチョウ
eagle	鹰	ワシ
duck	鸭	鴨
owl	猫头鹰	梟
crane	鹤	鶴
crow	乌鸦	鴉
cuckoo	杜鹃	カッコウ
swan	天鹅	白鳥
fish	鱼	魚
snake	蛇	蛇
worm	虫	虫
spider	蜘蛛	蜘蛛
ant	蚂蚁	アリ
midge	蚊子	蚊
fly	苍蝇	蝿
bark	吠	吠え
fly	飞	飛ぶ
sting	蛰	刺す
butterfly	蝴蝶	蝶
#亲属语义场
human	人类	人類
man	男人	男
woman	女人	女
child	孩子	子供
boy	男孩	男の子
girl	女孩	女の子
family	家庭	家庭
grandfather	爷爷	祖父
grandmother	奶奶	祖母
parents	父母	両親
father	父亲	父親
mother	母亲	母親
son	儿子	息子
daughter	女儿	娘
brother	兄弟	兄弟
sister	姐妹	姉妹
uncle	叔叔	おじ
aunt	阿姨	おば
husband	丈夫	夫
guest	客人	客人
friend	朋友	友人
companion	同伴	仲間
wife	妻子	妻
情感与价值语义场
joy	快乐	喜び
happiness	幸福	幸せ
grief	悲痛	悲しみ
wish	希望	希望
desire	渴望	願望
spirit	精神	精神
thought	思想	思想
memory	记忆	記憶
mind	心灵	心
meaning	意义	意味
reason	理由	理由
life	生命	命
death	死亡	死亡
grave	坟墓	墓
church	教堂	教会
sin	罪	罪
god	神	神
mistake	错误	過ち
lie	谎言	嘘
damage	损坏	損害
misfortune	不幸	不幸
fault	责任	責任
merry	愉快	愉快
sad	悲伤	悲しい
good	好	良い
bad	坏	悪い
correct	正确	正確
nasty	糟糕	不快
love	爱	愛
like	喜欢	好き
laugh	笑	笑う
weep	流泪	泣く
be annoyed	生气	怒る
be afraid	害怕	恐れる
calm	镇静	冷静
truth	真理	真理
#语言和文字语义场
speech	演讲	演説
language	语言	言語
voice	人声	人声
word	词	単語
sign	签字	サイン
call	称呼	呼び
tone	音调	トーン
fairy tale	童话	おとぎ話
story	故事	物語
message	讯息	メッセージ
news	新闻	ニュース
bracket	括号	括弧
book	书	本
character	字	文字
newspaper	报纸	新聞
say	说	言う
speak	谈	喋る
talk	谈论	話す
chat	聊天	チャット
ask	问	聞く
tell	告诉	教える
convey	表达	伝える
name	命名	名付け
brag	吹嘘	自慢
translate	翻译	翻訳
read	读	読む
write	写	書く
name	名字	名前
#现代世界语义场
doll	玩偶	人形
company	公司	会社
picture	照片	写真
figure	图形	図形
boss	老板	上司
master	能手	達人
doctor	医生	医者
teacher	老师	先生
money	钱	お金
business	商业	商業
shop	商店	商店
price	价格	値段
ware	商品	商品
profit	利润	利潤
wealth	财富	財産
firm	商行	商会
flat	公寓	アパート
boat	船	船
oar	桨	櫂
pasture	牧场	牧場
#数量语义场
count	计数	数える
sort	排序	仕分け
piece	块	片
part	部分	部分
heap	堆	堆積
bundle	一捆	束
step	步	一歩
half	一半	半分
first	第一	一番
second	第二	二番
one	一	一
two	二	二
three	三	三
four	四	四
five	五	五
six	六	六
seven	七	七
eight	八	八
nine	九	九
ten	十	十
a hundred	百	百
a thousand	千	千
measure	测量	測定
calculate	计算	計算
#行为和技术语义场
row	划	こぐ
load	装载	積む
become	成为	成る
happen	发生	起きる
begin	开始	はじめ
end	结束	終わる
change	改变	変わる
rise	上升	上がる
set	设定	設定
burn	烧	焼き
revolve	转动	回す
swing	摇摆	揺らす
fall	跌落	落下
boil	煮	煮る
snap	折断	折れる
sink	沉没	沈没
pass	传递	通る
appear	出现	現れる
disappear	消失	消える
drop	落下	落ちる
decrease	减少	減る
increase	增加	増える
grow	生长	成長
sparkle	闪烁	煌めく
be noisy	吵闹	騒ぎ
chime	鸣	鳴る
ring	响铃	響く
roar	咆哮	唸る
move	移动	移動
swim	游泳	泳ぐ
dive	潜水	潜る
drive	驾驶	運転
go	去	行く
depart	启程	出発
stop	停	止まる
go in	进去	入る
enter	进入	立ち入る
come	来	来る
arrive	到达	到着
come back	回来	帰る
stay	停留	とどまる
wait	等待	待つ
seek	寻求	探し求める
look for	找	探す
find	找到	探し出す
try	尝试	試す
prepare	准备	準備
watch	观看	観察
show	展示	展覧
do	做	やる
can	能	できる
want	想要	欲しい
finish	完成	完成
succeed	成功	成功
leave	离开	離れる
lose	输	負ける
make	制作	作る
produce	生产	生産
build	建	建てる
mend	修补	改める
improve	改进	改良
alter	改动	変える
connect	连接	接続
hide	隐藏	隠す
divide	分开	分ける
send	发送	送る
bring	带	連れる
add	加	加える
get	得到	得る
receive	接收	受け取る
choose	选择	選ぶ
select	选取	選択
preserve	维护	維持
hinder	阻碍	妨げる
spoil	破坏	破壊
damage	伤害	ダメージ
destroy	摧毁	ぶち壊す
promise	承诺	約束
praise	表扬	褒める
kiss	亲吻	キス
wake	唤醒	覚める
guide	引导	導く
teach	教	教え
instruct	指示	指示
bring up	抚养	育つ
lead	领导	指導
urge	敦促	促す
invite	邀请	誘う
unite	联合	結合
visit	参观	見学
meet	会面	合う
play	玩	遊ぶ
sing	唱	歌う
dance	跳舞	踊る
separate	分离	離す
rescue	营救	救う
guard	守卫	守衛
protect	保护	守る
defend	防御	防衛
brawl	打架	乱闘
shoot	射击	撃つ
win	赢	勝つ
annoy	激怒	イライラ
beat	节拍	拍
steal	偷	盗む
disturb	打扰	邪魔
bother	烦扰	悩ます
conceal	掩盖	隠匿
deceive	蒙骗	欺く
cheat	欺骗	騙す
kill	杀	殺す
dwell	居住	住む
hunt	狩猎	狩る
fish	钓鱼	釣る
gather	聚集	集合
pick	挑	摘み取る
decorate	装饰	飾る
request	请求	依頼
notice	通知	お知らせ
recognize	识别	識別
paint	绘画	絵画
draw	绘制	描く
endure	忍耐	耐える
trap	陷阱	罠
noose	套索	輪
track	追踪	追跡
escape	逃脱	脱出
#空间语义场
gap	间隙	すき
distance	距离	距離
area	地区	地域
space	空间	空間
place	地方	場所
side	一面	面
middle	中间	真ん中
edge	边缘	端
corner	角落	コーナー
north	北	北
south	南	南
west	西	西
east	东	東
near	靠近	近づく
far	远	遠い
left	左	左
right	右	右
here	这里	こっち
there	那里	そこ
forward	向前	前向き
backward	后退	バック
back	后	後ろ
below	下	下
down	向下	ダウン
above	上	上
up	向上	アップ
in front of	前	前
behind	后面	後
angle	角度	角度
#社会语义场
nation	国民	国民
work	工作	仕事
world	世界	世界
country	国家	国
state	州	州
king	国王	王
power	权力	権力
border	边界	境界
war	战争	戦争
enemy	敌人	敵
violence	暴力	暴力
fight	战斗	戦う
bow	弓	弓
arrow	箭	矢
gun	枪	銃
foreign	外国	外国
different	不同	違い
familiar	熟悉	聞き覚え
famous	著名	有名
rule	规则	規則
people	人们	人々
help	帮助	助かる
force	武力	軍隊
strength	力量	力
village	村庄	村
town	城镇	町
own	占有	所有
buy	买	買う
sell	卖	売る
pay for	付钱	支払う
pay	支付	払う
poor	穷	貧乏
rich	富	金持ち
#认知语义场
pattern	模式	模様
size	大小	サイズ
length	长度	長
height	高度	高
weight	重量	重
amount	数量	数
conclusion	结果	結果
delicate	精美	繊細
beautiful	漂亮	美しい
empty	空	空
clean	干净	きれい
dirty	脏	汚い
raw	生	生
ripe	成熟	熟す
delicious	美味	美味しい
black	黑	黒
white	白	白
red	红	赤
yellow	黄	黄色
blue	蓝	青い
green	绿	緑
grey	灰	灰色
colourful	鲜艳	鮮やか
cheap	便宜	安い
dear	亲爱的	愛しい
precious	珍贵	貴重
blind	盲	盲目
deaf	聋	ろうあ
powerful	强大	強い
strong	强壮	力強い
weak	虚弱	弱い
fat	胖	太い
slim	瘦	痩せ
pretty	美丽	かわいい
evil	邪恶	邪悪
stupid	愚蠢	愚か
lazy	懒	怠惰
diligent	勤奋	勤勉
stingy	吝啬	ケチ
clever	聪明	賢い
dream	梦	夢
gentle	温和	優しい
think	思考	思考
believe	相信	信じる
TRUE	真	真実
old	旧	古い
new	新	新しい
grasp	领悟	握る
understand	明白	分かる
learn	学	学ぶ
know	知道	知る
remember	记住	覚える
forget	忘记	忘れる
circle	圆形	円
cross	十字	横断
line	线条	線
#房屋语义场
wood	木	木材
board	木板	板
slab	板	平板
pole	杆	棒
stick	棍	小枝
pipe	管	パイプ
house	房	住宅
home	家	家
stove	炉	ストーブ
floor	地板	床
table	桌	机
chair	椅	椅子
cradle	摇篮	揺籃
bed	床	ベッド
shelf	架	棚
box	盒	箱
window	窗	窓
door	门	ドア
gate	大门	扉
fence	栅栏	塀
roof	屋顶	屋根
ladder	梯	はしご
broom	扫帚	ほうき
spade	锹	鋤
shovel	铲子	シャベル
fork	叉子	フォーク
nail	钉子	釘
net	网	網
hook	钩子	フック
handle	把手	ハンドル
lock	锁	錠
paint	油漆	塗料
glue	胶	膠
#食物和饮料语义场
spoon	勺子	スプーン
knife	刀	ナイフ
dishes	碟	皿
cup	杯	カップ
pot	锅	鍋
meal	饭	食事
food	食物	食べ物
dish	菜	料理
meat	肉	肉
corn	玉米	コーン
bread	面包	パン
fat	脂肪	脂肪
butter	黄油	バター
oil	油	オイル
salt	盐	塩
soup	汤	スープ
honey	蜂蜜	はちみつ
milk	牛奶	ミクル
tea	茶	ティー
cook	做饭	調理
bake	烘焙	焼く
fry	油炸	揚げ物
pork	猪肉	豚肉
rice	米饭	ご飯
noodle	拉面	ラーメン
beer	啤酒	ビール
fish	鱼肉	魚肉
beef	牛肉	牛肉
egg	鸡蛋	卵
wine	酒	酒
vegetable	蔬菜	野菜
#衣服语义场
leather	皮革	革
wool	羊毛	ウール
cloth	布	布
needle	针	針
thread	线	糸
button	扣子	ボタン
knot	结	結び目
clothes	衣服	服装
shirt	衬衫	シャツ
collar	衣领	襟
sleeve	袖子	袖
trousers	裤子	ズボン
belt	腰带	ベルト
cap	帽	帽子
shoe	鞋	靴
boot	靴	ブーツ
ring	戒指	指輪
ribbon	丝带	リボン
comb	梳子	櫛
mirror	镜子	鏡
strap	带子	吊り革
string	细绳	ひも
leash	皮带	鎖
blanket	被子	毛布
pillow	枕头	枕
scarf	围巾	スカーフ
towel	毛巾	タオル
naked	裸	裸
knit	织	編む
sew	缝	縫う
dye	染	染める
take off	脱	抜く
put on	穿	着く
comb	梳	くし
#时间语义场
age	年龄	歳
time	时间	時間
day	天	日
morning	早上	朝
noon	中午	昼
evening	晚上	晩
night	夜	夜
week	星期	週
month	月	月
year	年	年
spring	春	春
summer	夏	夏
autumn	秋	秋
winter	冬	冬
January	一月	一月
February	二月	二月
March	三月	三月
April	四月	四月
May	五月	五月
June	六月	六月
July	七月	七月
August	八月	八月
September	九月	九月
October	十月	十月
November	十一月	十一月
December	十二月	十二月
Monday	星期一	月曜日
Tuesday	星期二	火曜日
Wednesday	星期三	水曜日
Thursday	星期四	木曜日
Friday	星期五	金曜日
Saturday	星期六	土曜日
Sunday	星期日	日曜日
aged	年迈	年寄り
young	年轻	若い
last	最后	最後
at once	同时	同時に
together	一起	一緒
long	久	長い
suddenly	突然	突然
instantly	立即	すぐ
later	后来	その後
now	现在	今
today	今天	今日
tomorrow	明天	明日
soon	不久	間もなく
then	然后	次に
yesterday	昨天	昨日
once	一旦	一度
at that time	当时	当時
afterwards	以后	今後
before	以前	以前
sometimes	有时	時に
often	经常	たびたび
always	总是	いつも
never	从不	決して
#感觉语义场
big	大	大きい
little	小	小さい
long	长	長く
short	短	短い
wide	宽	広い
narrow	窄	狭い
dense	密集	濃い
thick	厚	厚い
thin	薄	薄い
smooth	光滑	滑らか
hard	硬	硬い
soft	软	柔らかい
round	圆	丸い
pointed	尖	尖
sharp	锋利	鋭い
blunt	钝	鈍い
heavy	重	重い
hot	热	暑い
warm	温暖	暖かい
cold	寒冷	寒い
cool	凉	冷たい
fresh	新鲜	新鮮
damp	潮湿	湿気
wet	湿	湿る
dry	干	乾い
full	满	満ち
sweet	甜	甘い
bitter	苦	苦い
sour	酸	酸っぱい
bright	明亮	輝く
dark	暗	暗い
ache	痛	痛い
feel	感觉	感覚
flavour	味道	味
odour	气味	気味
#动作语义场
open	开	開く
stand	站	立つ
sit	坐	座る
hang	挂	つるす
shout	喊	叫ぶ
drink	喝	飲む
eat	吃	食べる
swallow	吞	飲み込む
fall asleep	入睡	寝入る
sleep	睡	寝る
wake up	醒来	醒める
get up	起床	起き上がる
relax	休息	休む
budge	挪动	身動き
stand up	站起	立てる
sit down	坐下	座り
tumble	跌倒	転倒
pace	步伐	足並み
go for a walk	散步	散歩
rush	冲进	突進
dash	疾驰	ダッシュ
run	跑	走る
jump	跳	跳ぶ
climb	攀登	登る
creep	爬行	はう
hurry	赶快	急ぐ
groan	呻吟	うめき声
tremble	颤抖	震え
flee	逃	逃げる
see	看见	見る
look at	注视	注目
put	放	置く
hear	听见	聞こえ
listen	听	聴く
taste	品尝	味見
smell	闻	匂い
lay	摆	おろす
touch	摸	触る
pick up	捡起	拾い
seize	抓住	掴む
hold	拿着	保持
push	推	押す
scrape	刮	擦る
lick	舔	舐める
bite	咬	噛む
cut off	切断	切断
tie	系	結ぶ
stick	刺	突き刺す
break	打破	破る
knock	敲	ノック
hit	击打	打つ
dig	挖	掘る
bow	鞠躬	お辞儀
bend	弯曲	曲げる
raise	举起	上げる
press	按	押し
rub	摩擦	擦れる
spread	展开	広げる
grind	磨碎	磨く
cut	切	切る
jolt	震动	揺れる
shake	摇	揺する
swing	摆动	振る
pour	倒	倒れる
fill	填	満たす
wrap	包住	包む
carry	搬	運ぶ
drag	拖拽	引きずる
pull	拉	引く
keep	保持	保つ
throw	扔	投げる
catch	接住	受け止める
grab	抓	捕まえる
lift	抬升	持ち上げる
take	拿	持つ
give	给	あげる
kick	踢	蹴る
shove	撞	押し込む
tie up	拴	縛る
feed	喂	飼う
milk	挤奶	搾乳
clean	清洁	掃除
wash	洗	洗う
wipe	擦	拭く
rinse	冲洗	濯ぐ
sweep	扫	掃く
stir	搅动	かき回す
water	浇水	水増し
bath	洗澡	入浴
walk	步行	歩く
#功能词语义场
other	其他	その他
at first	首先	まず
hence	由此	故に
not	不	ない
a little	一点儿	少し
very	非常	とても
so	所以	だから
still	仍然	まだ
only	只有	ただ
already	已经	既に
again	再次	また
through	通过	通過
because of	因为	ため
this	这	これ
that	那	あれ
everything	一切	全て
I	我	私
you	你	君
he	他	彼
we	我们	我々
you	你们	君たち
they	他们	彼ら
what	什么	何
who	谁	誰
where	哪里	どこ
how	如何	どうして
why	为什么	なぜ
how much	多少	いくら
and	和	と

